1111111111111
1111101011111
111100E001111
1110CCPCC0111
110000C000011
111000C0M0111
1111010101111
1111100M11111
1111111111111