111111111111111111111111111111
1P00000010000000000010000000E1
101111101011111111101011111101
100000100000100000101010000101
111110111110101111101010111101
100010000010001000001010100001
101011111010101011101010101111
101010001010101010001010100001
101010101010101010101111111101
100010101000001010100000000101
111110101111101010111111110101
100010000010101000000001010001
101110111110101111111101010101
10000C00000C00000000C000000001
111111111111111111111111111111